# Riverdale

Season 1
- Chapter One: The River's Edge
- Chapter Two: A Touch of Evil
- Chapter Three: Body Double
- Chapter Four: The Last Picture Show
- Chapter Five: Heart of Darkness
- Chapter Six: Faster, Pussycats! Kill! Kill!
- Chapter Seven: In a Lonely Place
- Chapter Eight: The Outsiders
- Chapter Nine: La Grande Illusion
- Chapter Ten: The Lost Weekend
- Chapter Eleven: To Riverdale and Back Again
- Chapter Twelve: Anatomy of a Murder
- Chapter Thirteen: The Sweet Hereafter

Season 2
- Chapter Fourteen: A Kiss Before Dying
- Chapter Fifteen: Nighthawks
- Chapter Sixteen: The Watcher in the Woods
- Chapter Seventeen: The Town That Dreaded Sundown
- Chapter Eighteen: When a Stranger Calls
- Chapter Nineteen: Death Proof
- Chapter Twenty: Tales from the Darkside
- Chapter Twenty-One: House of the Devil
- Chapter Twenty-Two: Silent Night, Deadly Night
- Chapter Twenty-Three: The Blackboard Jungle
- Chapter Twenty-Four: The Wrestler
- Chapter Twenty-Five: The Wicked and the Divine
- Chapter Twenty-Six: The Tell-Tale Heart
- Chapter Twenty-Seven: The Hills Have Eyes
- Chapter Twenty-Eight: There Will Be Blood
- Chapter Twenty-Nine: Primary Colors
- Chapter Thirty: The Noose Tightens
- Chapter Thirty-One: A Night to Remember
- Chapter Thirty-Two: Prisoners
- Chapter Thirty-Three: Shadow of a Doubt
- Chapter Thirty-Four: Judgment Night
- Chapter Thirty-Five: Brave New World

Season 3
- Chapter Thirty-Six: Labor Day
- Chapter Thirty-Seven: Fortune and Men's Eyes
- Chapter Thirty-Eight: As Above, So Below
- Chapter Thirty-Nine: The Midnight Club
- Chapter Forty: The Great Escape
- Chapter Forty-One: Manhunter
- Chapter Forty-Two: The Man in Black
- Chapter Forty-Three: Outbreak
- Chapter Forty-Four: No Exit
- Chapter Forty-Five: The Stranger
- Chapter Forty-Six: The Red Dahlia
- Chapter Forty-Seven: Bizarrodale
- Chapter Forty-Eight: Requiem for a Welterweight
- Chapter Forty-Nine: Fire Walk with Me
- Chapter Fifty: American Dreams
- Chapter Fifty-One: Big Fun
- Chapter Fifty-Two: The Raid
- Chapter Fifty-Three: Jawbreaker
- Chapter Fifty-Four: Fear the Reaper
- Chapter Fifty-Five: Prom Night
- Chapter Fifty-Six: The Dark Secret of Harvest House
- Chapter Fifty-Seven: Survive the Night

Season 4
- Chapter Fifty-Eight: In Memoriam
- Chapter Fifty-Nine: Fast Times at Riverdale High
- Chapter Sixty: Dog Day Afternoon
- Chapter Sixty-One: Halloween
- Chapter Sixty-Two: Witness for the Prosecution
- Chapter Sixty-Three: Hereditary
- Chapter Sixty-Four: The Ice Storm
- Chapter Sixty-Five: In Treatment
- Chapter Sixty-Six: Tangerine
- Chapter Sixty-Seven: Varsity Blues
- Chapter Sixty-Eight: Quiz Show
- Chapter Sixty-Nine: Men of Honor
- Chapter Seventy: The Ides of March
- Chapter Seventy-One: How to Get Away with Murder
- Chapter Seventy-Two: To Die For
- Chapter Seventy-Three: The Locked Room
- Chapter Seventy-Four: Wicked Little Town
- Chapter Seventy-Five: Lynchian
- Chapter Seventy-Six: Killing Mr. Honey

Season 5
- Chapter Seventy-Seven: Climax
- Chapter Seventy-Eight: The Preppy Murders
- Chapter Seventy-Nine: Graduation
- Chapter Eighty: Purgatorio
- Chapter Eighty-One: The Homecoming
- Chapter Eighty-Two: Back to School
- Chapter Eighty-Three: Fire in the Sky
- Chapter Eighty-Four: Lock & Key
- Chapter Eighty-Five: Destroyer
- Chapter Eighty-Six: The Pincushion Man
- Chapter Eighty-Seven: Strange Bedfellows
- Chapter Eighty-Eight: Citizen Lodge
- Chapter Eighty-Nine: Reservoir Dogs
- Chapter Ninety: The Night Gallery
- Chapter Ninety-One: The Return of the Pussycats
- Chapter Ninety-Two: Band of Brothers
- Chapter Ninety-Three: Dance of Death
- Chapter Ninety-Four: Next to Normal
- Chapter Ninety-Five: RIVERDALE: RIP (?)

Season 6
- Chapter Ninety-Six: Welcome to Rivervale
- Chapter Ninety-Seven: Ghost Stories
- Chapter Ninety-Eight: Mr. Cypher
- Chapter Ninety-Nine: The Witching Hour(s)
- Chapter One Hundred: The Jughead Paradox
- Chapter One Hundred and One: Unbelievable
- Chapter One Hundred and Two: Death at a Funeral
- Chapter One Hundred and Three: The Town
- Chapter One Hundred and Four: The Serpent Queen's Gambit
- Chapter One Hundred and Five: Folk Heroes
- Chapter One Hundred and Six: Angels in America
- Chapter One Hundred and Seven: In the Fog
- Chapter One Hundred and Eight: Ex-Libris
- Chapter One Hundred and Nine: Venomous
- Chapter One Hundred and Ten: Things That Go Bump in the Night
- Chapter One Hundred and Eleven: Blue Collar
- Chapter One Hundred and Twelve: American Psychos
- Chapter One Hundred and Thirteen: Biblical
- Chapter One Hundred and Fourteen: The Witches of Riverdale
- Chapter One Hundred and Fifteen: Return to Rivervale
- Chapter One Hundred and Sixteen: The Stand
- Chapter One Hundred and Seventeen: Night of the Comet
